0000000s
00000000
s0s0000s
00000000
00000000
00000000
r0000000
00000000
00000000
00000000
t0000000
ssa00000