0000000s
00000000
0000000a
00000000
00000000
00000000
sss000ss
00000000
00000000
00000000
00000000
s000et00