v00s000s
0000000e
00000000
00000000
00000000
00000000
00000000
00000000
00000000
00000000
00000000
s00t0000